1111111111111111111111111111111111
1E000000010000C0000100C001000000C1
1000000001000000000100000100000001
1P00000001000000000100000100000001
1000000001000000000100000100000001
1000000001000000000100000100000001
1000000001000000000100000100000001
1000000000000000000000000000000001
1000000000000000000000000000000001
1000000000000000000000000000000001
1000000000000000000000000000000001
1C000000000000C00000000000000000C1
1111111111111111111111111111111111